NO /home/rick/Documents/42/projects/cub3d/myversion/textures/wallmonkey.png
SO /home/rick/Documents/42/projects/cub3d/myversion/textures/wallmonkey.png
WE /home/rick/Documents/42/projects/cub3d/myversion/textures/wallmonkey.png
EA /home/rick/Documents/42/projects/cub3d/myversion/textures/wallmonkey.png

F 70,70,80
C 30,30,30

111111111111111111111
100000000000000000001
100000000000000000001
100000000000000000001
100000111110000000001
100000100010000000001
100000100010000000001
100000100010000000001
100000111110000000001
100000000000000000001
100000000000000000001
100000000E00000000001
100000000000000000001
100000000000000000001
111111111111111111111
