NO ./textures/wallmonkey.png
SO ./textures/wallmonkey.png
WE ./textures/wallmonkey.png
EA ./textures/wallmonkey.png

F 70,70,80
C 30,30,30

11111111111111111111        11111111111111111111
100000000000000000011111111110000000000000000001
111100111000001111000111111111111111110111111111
1111001110000011110000000000000000000001
1000001111111111110000000000000000000001
1000001111111111110000000000000000000001
1111100000001111110000000000S00000000001
1111111111100000011000000000000000000011
1111111111100000011100000000000000000111
1111111111100000011110000000000000001111
1111111111100000011111000000000000011111
1111111111111111111111111000000011111111
1111111111111111111111111111011111111111
1000000000000000000000000000011111111111
101111111111111111111111111111
100000000000000111111111111111
1000000000000001
1000000000000001
1000000000000001
1111111111111111
